AAAAAABP
--------*---SSSS------------SSSS*-------------------
------------SSSS------------SSSS--------------------
------------SSSS------------SSSS--------------------
------------SSSS------------SSSS--------------------
TTTTBBBB----SSSS------------BBBB----BBBB----BBBB----
TTTTBBBB----SSSS------------BBBB----BBBB----BBBB----
TTTTBBBB----SSSS------------BBBB----BBBB----BBBB----
TTTTBBBB----SSSS------------BBBB----BBBB----BBBB----
TTTTBBBB----TTTTTTTTTTTTBBBBBBBB----BBBBSSSSBBBB----
TTTTBBBB----TTTTTTTTTTTTBBBBBBBB----BBBBSSSSBBBB----
TTTTBBBB----TTTTTTTTTTTTBBBBBBBB----BBBBSSSSBBBB----
TTTTBBBB----TTTTTTTTTTTTBBBBBBBB----BBBBSSSSBBBB----
TTTT*-------BBBB--------BBBBBBBB----SSSS--------SSSS
TTTT--------BBBB--------BBBBBBBB----SSSS--------SSSS
TTTT--------BBBB--------BBBBBBBB----SSSS--------SSSS
TTTT--------BBBB--------BBBBBBBB----SSSS--------SSSS
TTTT--------BBBB----BBBBSSSS--------BBBBTTTTBBBBSSSS
TTTT--------BBBB----BBBBSSSS--------BBBBTTTTBBBBSSSS
TTTT--------BBBB----BBBBSSSS--------BBBBTTTTBBBBSSSS
TTTT--------BBBB----BBBBSSSS--------BBBBTTTTBBBBSSSS
TTTTTTTT----BBBB----BBBB--------SSSSBBBBTTTT----*---
TTTTTTTT----BBBB----BBBB--------SSSSBBBBTTTT--------
TTTTTTTT----BBBB----BBBB--------SSSSBBBBTTTT--------
TTTTTTTT----BBBB----BBBB--------SSSSBBBBTTTT--------
BBBBBBBBBBBBBBBB----TTTTTTTTSSSSBBBBBBBBTTTTBBBB----
BBBBBBBBBBBBBBBB----TTTTTTTTSSSSBBBBBBBBTTTTBBBB----
BBBBBBBBBBBBBBBB----TTTTTTTTSSSSBBBBBBBBTTTTBBBB----
BBBBBBBBBBBBBBBB----TTTTTTTTSSSSBBBBBBBBTTTTBBBB----
------------SSSSTTTTBBBB----BBBB----BBBB----BBBB----
------------SSSSTTTTBBBB----BBBB----BBBB----BBBB----
------------SSSSTTTTBBBB----BBBB----BBBB----BBBB----
------------SSSSTTTTBBBB----BBBB----BBBB----BBBB----
SSSSBBBBWWWWSSSS----BBBB----BBBB----WWWWWWWWBBBBWWWW
SSSSBBBBWWWWSSSS----BBBB----BBBB----WWWWWWWWBBBBWWWW
SSSSBBBBWWWWSSSS----BBBB----BBBB----WWWWWWWWBBBBWWWW
SSSSBBBBWWWWSSSS----BBBB----BBBB----WWWWWWWWBBBBWWWW
WWWWBBBB----BBBB----BBBBBBBBBBBB----BBBBSSSSBBBBWWWW
WWWWBBBB----BBBB----BBBBBBBBBBBB----BBBBSSSSBBBBWWWW
WWWWBBBB----BBBB----BBBBBBBBBBBB----BBBBSSSSBBBBWWWW
WWWWBBBB----BBBB----BBBBBBBBBBBB----BBBBSSSSBBBBWWWW
TTTTBBBB----BBBB----BBBBBBBBBBBB----BBBBSSSSBBBBWWWW
TTTTBBBB----BBBB----BBBBBBBBBBBB----BBBBSSSSBBBBWWWW
TTTTBBBB----BBBB----BBBBBBBBBBBB----BBBBSSSSBBBBWWWW
TTTTBBBB----BBBB----BBBBBBBBBBBB----BBBBSSSSBBBBWWWW
WWWWBBBB----------------------------BBBB----BBBBWWWW
WWWWBBBB----------------------------BBBB----BBBBWWWW
WWWWBBBB--------------BBBBBBBB------BBBB----BBBBWWWW
WWWWBBBB--------------BBBBBBBB------BBBB----BBBBWWWW
WWWWBBBB----BBBB+-----BBE---BB------BBBBBBBBBBBBWWWW
WWWWBBBB----BBBB------BB----BB------BBBBBBBBBBBBWWWW
WWWWBBBB----BBBB------BB----BB------BBBBBBBBBBBBWWWW
WWWWBBBB----BBBB------BB----BB------BBBBBBBBBBBBWWWW
